1
15 20
1 0 0 0 1 1 0 0 0 0 0 0 0 0 0 0 0 0 0 0  
0 0 0 0 0 0 0 0 0 0 0 0 0 0 0 0 0 0 0 0   
0 0 0 0 0 0 0 0 0 0 0 0 0 0 0 0 0 0 0 0   
0 0 0 0 1 1 0 0 0 0 0 0 0 0 0 0 0 0 0 0  
0 0 0 0 1 1 1 0 0 0 0 0 0 0 0 0 0 0 0 0    
1 0 0 0 1 1 1 1 0 0 0 1 0 0 0 0 0 0 0 0   
0 0 0 0 1 0 0 0 0 0 0 0 0 0 0 0 0 0 0 0   
0 0 0 0 0 0 0 0 1 1 1 1 0 0 1 0 0 0 0 0   
0 0 0 0 0 0 0 0 1 1 0 0 0 0 0 0 0 0 0 0   
0 0 0 0 0 0 0 1 1 1 0 0 0 0 0 0 0 0 0 0   
0 0 0 0 0 0 0 1 1 1 1 1 0 0 0 0 0 1 1 1   
0 0 0 0 0 0 0 0 0 0 0 0 0 0 0 0 0 0 0 1   
0 0 0 0 0 0 0 0 0 0 0 0 0 0 0 0 0 0 0 1   
1 1 1 0 0 0 0 0 0 0 0 0 0 0 1 1 1 1 1 1   
1 1 1 1 1 1 1 1 1 1 1 1 1 1 1 1 1 1 1 1

2
15 20
0 0 0 0 0 0 0 0 0 0 0 0 0 0 0 0 0 0 0 0  
0 0 0 0 0 0 0 0 0 0 0 0 0 0 0 0 0 0 0 0   
0 0 0 0 0 0 0 0 0 0 0 0 0 0 0 0 0 0 0 0   
0 0 0 0 0 0 0 0 0 0 0 0 0 0 0 0 0 0 0 0   
0 0 0 0 0 0 0 0 0 0 0 0 0 0 0 0 0 0 0 0   
0 0 0 0 0 0 0 0 0 0 0 0 0 0 0 0 0 0 0 0   
0 0 0 0 0 0 0 0 0 0 0 0 0 0 0 0 0 0 0 0   
0 0 0 0 0 0 0 0 1 1 0 0 0 0 0 0 0 0 0 0   
0 0 0 0 0 0 0 0 1 1 0 0 0 0 0 0 0 0 0 0   
0 0 0 0 0 0 0 0 1 1 0 0 0 0 0 0 0 0 0 0   
0 0 0 0 0 0 0 1 1 1 1 0 0 0 0 0 0 0 0 0   
0 0 0 0 0 0 0 0 0 0 0 0 0 0 0 0 1 1 0 0   
0 0 0 0 0 0 0 0 0 0 0 0 0 0 0 0 1 0 0 0   
1 1 1 0 0 0 0 0 0 0 0 0 0 0 1 1 1 1 1 1   
1 1 1 1 1 1 1 1 1 1 1 1 1 1 1 1 1 1 1 1